1111111
1000001
1000001
1000001
10010N1
1001001
1001001
1111111